#######################
#S  #         #     # #
## # # ##### ### ### ##
#  ## #   #   # # #   #
# ## ## # ### # # #####
#     # #     # #     #
### # # # ### ##### ###
#   # #   # #   #     #
# ### ##### ### ##### #
#     #       #   # # #
##### # ##### ### ### #
#   #   #     #     # #
# # ##  # ### ### # ###
# #     #   # # # # # #
# ##### ### ### # # ###
# #   # # #     #     #
# ### # # # ### ##### #
#     # #   #       # #
#######E###############