#########
#S ## # #
## # # ##
#  ## # #
# ## ## #
#       #
#######E#