########################
#S  #       #       # #
### # ##### # ##### ####
#   # #   #   #   #   #
# # ### ##### # # #####
# #       #   # # #   #
# ##### # ##### # ### #
#   #   #     #     # #
### ### ### ##### #####
#     # # #       #   #
##### ### # ##### #####
#   #     #     #     #
# # # ##### ##### #####
# # #     #   #     # #
### ##### ### ##### # #
#     #       #     # #
##### ##### # ### #####
#     #     #       # #
#######E################