###########
#S  #    E#
## # #### #
#  ##     #
# ## ## # #
#       # #
###########